xxxxxxxxxxxxxxxxxxxx
x                  x
x            x     x
x            xx    x
x                  x
x  xx  xxxxxx  xx  x
x                  x
x                  x
x                  x
x           x     xx
x    xx  xx  xx    x
x         xxx     xx
x         x        x
x         x     xxxx
x        xxxx      x
x                  x
x              x   x
x  xx  xx x   x    x
x         x        x
xxxxxxxxxxxxxxxxxxxx
